NO ./textures/north_texture.txt

SO ./textures/south_texture.txt

WE ./textures/west_texture.txt


EA ./textures/east_texture.txt

F 220,255,1
C 225,30,0




      1111111111111111111111111
      111111111111100000111001
      1000000010011111111111111
      100011111001
      100001100001
      100001000001
111111111111111111
1000000001101
1111000001111
1000000001
100N001001
1010000011
100000000111111111
111111100000000001
111111111111111111