NO ../../textures/east_texture.txt

SO ../../textures/east_texture.txt

WE ../../textures/east_texture.txt


EA ../../textures/east_texture.txt

F 220,255,0
C 225,30,0





        1111111111111111111111111
        1000000000110000000000001
        1011000001110000000000001
        1001000000000000000000001
111111111011000001110000000000001
100000000011000001110111111111111
11110111111111011100000010001
1110111111111011101010010001
11000000110101011100000010001
10000000000000001100000010001
10000000000000001101010010001
11000001110101011111000000N01
1111011111101011011110100011111
111111111111111111111111111
1111111111111111111111111111111111111111111111
11