NO ./textures/north_texture.txt

SO ./textures/south_texture.txt

WE ./textures/west_texture.txt


EA ./textures/east_texture.txt

F 220,123,43
C 135,206,235





11111111111111111111111111111111
1000000000000000000000000000001
100011111001111111111001111100011111
10001000000000000000000000010001000011111111
100000001010101010101010000000010000 10010001
100000000000000000000000000000010000 10000001
100000110001111111111100110000011111110000101
100000100000000000000000010000000000000010001
100000000000000000000000000000000000000000001
100000000000111111110000000000011111110010001
100000100000100000000000010000010000010000101
100000100000100000000000010000010000010000001
100000000000111111110000000000010000011100111
1000000000000000000000000000000100000001001
1000001000000000000000000100000100000001001
1000001100011111111111001100000100000001001
100000000000000000000000000000010000001001
100000001010101010101010000000010000001001
1000100000S0000000000000000100010000001001
100011111001111111111001111100010000001001
100000000000000000000000000000010000001001
111111111111110011111111111111110000001001
             100100000000000000000000 1001
             100100000000000000000000 1001
             100100000000000000000000 1001
             100111111111111111111111111001
             100000000000000000000000000001
            111111111111111111111111111111111
111111111111