11111111
10010001
10100001
1100N001
11111111
